C1,C2,C3,C4,C5,C6,C7,C8,C9,C10,C11,C12,C13,C14,C15
0,0,0,0,0,0,0,0,0,0,0,0,0,0,0
0,0,0,0,0,0,0,0,0,0,0,0,0,0,0
0,0,0,0,0,0,0,0,0,0,0,0,0,0,0
0,0,0,0,0,0,0,0,0,0,0,0,0,0,0
0,0,0,0,0,0,0,0,0,0,0,0,0,0,0
0,0,0,30,24,24,24,24,24,24,24,30,0,0,0
0,0,0,-30,-29,-29,-29,-29,-29,-29,-29,-30,0,0,0
0,0,0,-30,-29,-58,-29,-42,-29,-58,-29,-30,-93,-49,0
0,0,-51,-30,-29,-29,-29,-41,-29,-29,-29,-30,1,1,-50
0,0,2,2,2,2,2,2,2,2,2,2,2,2,1
