C1,C2,C3,C4,C5,C6,C7,C8,C9,C10,C11,C12,C13,C14,C15
0,0,0,0,0,0,0,0,0,0,0,0,0,0,0
0,0,0,0,0,0,0,0,0,0,0,0,0,0,0
0,0,0,0,0,0,0,0,0,0,0,0,0,0,0
0,0,0,0,0,0,0,0,0,0,0,0,0,0,0
0,0,30,30,30,30,30,30,30,30,30,0,0,0,0
0,0,30,29,29,29,29,29,29,29,30,0,0,-40,0
0,0,30,29,58,29,44,29,58,29,30,0,0,-29,0
0,-56,30,29,29,29,43,29,29,29,30,-49,0,-29,-51
1,1,1,1,1,1,1,1,1,1,1,1,1,1,1
2,2,2,2,2,2,2,2,2,2,2,2,2,2,2
