C1,C2,C3,C4,C5
0,0,0,0,0
0,0,0,1,0
0,0,0,2,0
0,0,1,2,0
0,1,2,2,0
0,2,3,2,1
0,2,3,3,2
0,2,3,3,2
1,2,3,3,2
2,3,3,3,2
