C1,C2,C3,C4,C5,C6,C7,C8,C9,C10
0,0,0,0,0,0,0,0,0,0
0,0,0,0,0,0,0,0,0,0
0,0,0,0,0,0,0,0,0,0
0,0,0,0,0,0,0,0,0,0
0,0,0,0,0,0,0,0,0,0
0,0,0,0,78,0,0,0,0,0
0,0,0,0,78,0,0,0,0,0
0,-93,-93,79,79,-93,-93,-93,-93,0
0,79,79,83,83,79,79,79,79,-57
83,83,83,83,83,83,83,83,83,83
