C1,C2,C3,C4,C5,C6,C7,C8,C9,C10,C11,C12,C13,C14,C15
0,0,0,0,0,0,0,0,0,0,0,0,0,0,0
0,0,0,0,0,0,0,0,38,0,0,0,0,0,0
0,0,0,0,0,0,0,38,38,38,0,0,0,0,0
0,0,0,0,0,0,0,0,-30,0,0,0,0,0,0
0,0,0,0,0,0,0,0,-30,0,0,0,0,0,0
0,0,0,0,0,0,89,0,-30,0,0,0,0,0,0
0,0,0,-51,0,0,1,1,1,0,-49,0,0,0,0
0,0,-50,1,1,1,2,2,2,1,1,0,-52,0,0
0,0,1,2,2,2,2,2,2,2,2,1,1,0,0
0,0,2,2,2,2,2,2,2,2,2,2,2,0,0
